// This map is copied from the NES game with the same name

7 8 0.05 42
O O O O O O O O O O O O O O O
O - - - - - - - - - - - - - O
O - O - O - O - O - O - O - O
O - O - O - O - O - O - O - O
O - O - O - O - O - O - O - O
O - O - O - O - O - O - O - O
O - O - O - - - - - O - O - O
O - - - - - O - O - - - - - O
O - - O O - - - - - O O - - O
O - - - - - O O O - - - - - O
O - O - O - O - O - O - O - O
O - O - O - O - O - O - O - O
O - O - O - - - - - O - O - O
O - - - - - - - - - - - - - O
O O O O O O O O O O O O O O O
